28
15
0 0 0 0 0 0 0 0 0 0 0 0 0 0 0 0 0 0 0 0 0 0 0 0 0 0 0 0 
21 2 0 0 0 0 0 0 0 0 0 0 0 0 0 0 0 0 0 24 24 24 0 0 0 0 1 21 
22 4 0 0 0 0 0 0 0 24 0 0 0 24 0 0 0 0 0 0 0 0 0 0 0 0 3 22 
22 4 0 0 0 0 0 24 24 0 0 0 0 0 0 0 0 24 0 0 0 0 0 0 0 0 3 22 
22 4 0 0 0 0 0 0 0 0 0 0 0 0 0 0 0 0 24 0 0 0 0 0 24 0 3 22 
22 4 0 24 24 0 24 0 0 0 0 0 0 0 0 0 0 0 0 0 0 0 24 0 0 0 3 22 
22 4 0 0 0 0 0 0 0 0 24 24 24 24 24 24 24 0 0 0 0 0 0 0 0 24 3 22 
22 4 0 0 24 0 0 24 0 0 0 0 0 0 0 0 0 0 24 0 0 24 24 24 24 24 3 22 
22 4 24 0 0 0 0 0 0 0 0 24 24 24 0 0 0 0 0 0 0 0 24 0 0 0 3 22 
22 4 0 0 0 0 23 24 25 0 0 0 0 0 24 24 0 0 0 24 0 0 24 0 0 0 3 22 
22 4 0 0 0 0 0 0 0 0 0 0 0 0 0 0 0 0 0 0 0 0 24 24 24 0 3 22 
22 4 0 23 24 25 0 0 0 0 0 0 24 0 0 0 0 24 0 0 24 0 0 0 24 0 3 22 
22 4 0 0 0 0 0 0 0 0 0 0 0 24 24 0 0 0 0 0 0 0 0 0 0 0 3 22 
5 21 21 21 21 21 21 21 21 21 21 21 21 21 21 21 21 21 21 21 21 21 21 21 21 21 21 6 
22 22 22 22 22 22 22 22 22 22 22 22 22 22 22 22 22 22 22 22 22 22 22 22 22 22 22 22 
