20
15
0 0 0 0 0 0 0 0 0 0 0 0 0 0 0 0 0 0 0 0 
0 0 0 0 0 0 0 0 0 0 0 0 0 0 0 0 0 0 0 0 
0 0 0 0 0 0 0 0 0 0 0 0 0 0 0 0 0 0 0 0 
0 0 0 0 0 0 0 0 0 0 0 0 0 0 0 0 0 0 0 0 
0 0 0 0 0 0 0 0 0 0 0 0 0 0 0 0 0 0 0 0 
21 2 0 0 0 0 0 0 0 0 0 0 0 0 0 0 0 0 0 0 
22 4 0 0 0 0 0 0 23 24 24 24 25 0 0 0 0 0 1 21 
22 4 0 23 24 25 0 0 0 0 0 0 0 0 0 0 23 25 3 22 
22 4 0 0 0 0 0 0 0 0 0 0 0 0 0 0 0 0 3 22 
22 4 0 0 0 0 0 23 25 0 0 0 0 23 24 25 0 0 3 22 
22 4 23 25 0 0 0 0 0 0 0 0 0 0 0 0 0 0 3 22 
22 4 0 0 0 0 0 0 0 23 24 24 25 0 0 0 0 0 3 22 
22 4 0 23 24 24 25 0 0 0 0 0 0 0 0 0 0 0 3 22 
22 4 0 0 0 0 0 0 0 0 0 0 0 0 0 0 0 0 3 22 
5 21 21 21 21 21 21 21 21 21 21 21 21 21 21 21 21 21 21 6 
